NO    ./textures/xpm/bluestone.xpm
SO      ./textures/xpm/colorstone.xpm
WE ./textures/xpm/greystone.xpm
EA ./textures/xpm/mossy.xpm
F 102,106,110
C 199,228,255

1111111111111111
1E00000000000001
1000001000000001
 000001100000001
1000000000000001
 100000000000001
1000001000000001
1000000000100001
1111111111111111

