NO          ./path_to_the_north_texture
SO      ./path_to_the_south_texture
WE    ./path_to_the_west_texture
EA ./path_to_the_east_texture

F 220,100,0
C 225,30,0

1111111111111111
10000000000000S1
100000100D000001
1000001100000001
1000000000000001
1010001000000001
1000000000100001
1111111111111111
